00000000000000000000000000000000000
00000000000000000000000000000000000
00000000000000000000000000000000000000000000511111111111111116
00000000111111111111111100000000000000000005000000000000000004
00000000000000000000000000000000000000000050000000000000000004
00000000000000000000000000000000000000000500000000000000000004
00000000000000000000000000000000000000005000000000000000000004
51111111111600000051111111111111116000050000000000000000000000111111111111111111111
30000000000400000030000000000000004000030000000000000000000000000000000000000000000
30000000000400000030000000000000004000030000000000000000000000000000000000000000000
30000000000400000030000000000000000000030000000000000000000000000000000000000000000
30000000000400000030000000000000000000030000000000000000000000000000000000000000000
30000000000400000030000000000000000000030000000000000000000000000000000000000000000
72222222222800000072222222222222228000030000000000000000000000000000000000000000000