0
0
00000000000000000000000000000000000000000000511111111111111116
00000000000000000000000000000000000000000005000000000000000004
00000000000000000000000000000000000000000050000000000000000004
00000000000000000000000000000000000000000500000000000000000004
00000000000000000000000000000000000000005000000000000000000004
51111111111600000051111111111111116000050000000000000000000000111111111111111111111